1,1 15 1,2 90 1,3 40 1,4 10 1,5 25
2,1 30 2,2 75 2,3 95 2,4 60 2,5 50
3,1 85 3,2 5 3,3 20 3,4 100 3,5 12
4,1 25 4,2 15 4,3 55 4,4 70 4,5 45
5,1 90 5,2 10 5,3 30 5,4 5 5,5 15